1111111111111111111
1220000000000000011
1220000000000000001
1021000000001111111
101P100000001E00001
1001000000001000001
1000000000001111111
1000000000000000001
1111111111111111111