1111111111111111111
1000000001111111111
1922923383381111111
