111111111111111111
110000000000000001
110100000000111111
1111000PC0000E0001
110100000000111101
111111111111111111