111111111111111111111111111111111111111111111111111111111111111111111111111111111111111111111111111111111111111111111111111111111111111111111111
1100C000000000C000100000000010000000000000000000000000000000100000000000100000001000000000000000000000000000000000000000000000000000000000000001
110000000000000000100000000010000000000000000000000C00000000100000000000000000001000000000000000000000000000001000000000000000001000000000000001
1100000N0C0000000010C0010000100000C0000001000000000000000000100000010000000000001000000000000001000000000000000000000000000000000000000000000001
110000000000000000100000000010000000000000000000000000000000100000000000000000001000000000000000000000010000000000000100000000000000000000000001
11000000000N000000100N000000100000000C0000000000000000000000100000000000000000001000000000000000000000000000000000000000000000000000000000000001
1100C0000000000000000001000000000000000000000000000C00N00000000000010000000000000000000000000000001000000000000010000000000000000001000000000001
110000000000000000100000000010000000000000000000000000000000100000000000000000001000000000000000000000000000000000000000000000000000000000000001
11000000CC00000000100000000010000000N00C00000000000000000000100000000000000000001000000000000000000000000000000000000000000000000000000000000001
110000000000000000100000000010C000000000000000000C0000000000100000000000010000001000000000000000000000000000000000000100000000000000000000000001
11000000000000C0001000000000100000N0000000000000000110000000100000000000000000001000000000000000000000000000000000000000000000000000000000000001
1100C000000000C00010000000001000000000000000000N000111000000100000000000100000001000000000000000000000000000000000000000000000000000000000000001
11000000000000000010000000001000000000000N000000C00011100000100000000000000000001000000000000000000000000000001000000000000000001000000000000001
110000000C0000000010C0010000100000C0000001000000000000000000100000010000000000001000000000000001000000000000000000000000000000000000000000000001
1100N0000000000000100000000010000000000000000000000000000000100000000000000000001000000000000000000000010000000000000100000000000000000000000001
1100000000000000001000000000100000000C0000000000000000000000100000000000000000001000000000000000000000000000000000000000000000000000000000000001
1100C00000000N0000000001000000000000000000000000000C00000000000000010000000000000000000000000000001000000000000010000000000000000001000000000001
11000000000000000010000000001000N0000P00CCCCCCCCCCCC00000000111111111111111111111000000000000000000000000000000000000000000000000000000000000001
11000000CC00000000100000000010000000000C00000000000000000000100000000000000000001000000000000000000000000000000000000000000000000000000000000001
110000000000000000100000000010C000000000000000000C0000000000100000000000010000001000000000000000000000000000000000000100000000000000000000000001
11000000000000C000100000000010000000000000000000000000000000000000E00000000000001000000000000000000000000000000000000000000000000000000000000001
1100C000000000C000100000000010000000000000000000000000000000100000000000100000001000000000000000000000000000000000000000000000000000000000000001
110000000000000000100000000010000000000000000000000C00000000100000000000000000001000000000000000000000000000001000000000000000001000000000000001
110000000C0000000010C0010000100000C0000001000000000000000000100000010000000000001000000000000001000000000000000000000000000000000000000000000001
110000000000000000100000000010000000000000000000000000000000100000000000000000001000000000000000000000010000000000000100000000000000000000000001
1100000000000000001000000000100000000C0000000000000000000000111111111111111111111000000000000000000000000000000000000000000000000000000000000001
1100C0000000000000000001000000000000000000000000000C00000000000000010000000000000000000000000000001000000000000010000000000000000001000000000001
110000000000000000100000000010000000000000000000000000000000100000000000000000001000000000000000000000000000000000000000000000000000000000000001
11000000CC00000000100000000010000000000C00000000000000000000100000000000000000001000000000000000000000000000000000000000000000000000000000000001
110000000000000000100000000010C000000000000000000C0000000000100000000000010000001000000000000000000000000000000000000100000000000000000000000001
11000000000000C000100000000010000000000000000000000000000000100000000000000000001000000000000000000000000000000000000000000000000000000000000001
1100C000000000C000100000000010000000000000000000000000000000100000000000100000001000000000000000000000000000000000000000000000000000000000000001
110000000000000000100000000010001111100000000000000C00000000100000000000000000001000000000000000000000000000001000000000000000001000000000000001
110000000C0000000010C0010000100000C0010001000000000000000000100000010000000000001000000000000001000000000000000000000000000000000000000000000001
110000000000000000100000000010010000010000000000000000000000100000000000000000001000000000000000000000010000000000000100000000000000000000000001
110000000000000000100000000010001111110000000000000000000000100000000000000000001000000000000000000000000000000000000000000000000000000000000001
1100C0000000000000000001000000000000000000000000000C00000000000000010000000000000000000000000000001000000000000010000000000000000001000000000001
110000000000000000100000000010000000001110000000000000000000100000000000000000001000000000000000000000000000000000000000000000000000000000000001
11000000CC00000000100000000010000000000C10000000000000000000100000000000000000001000000000000000000000000000000000000000000000000000000000000001
110000000000000000100000000010C000000111100000000C0000000000100000000000010000001000000000000000000000000000000000000100000000000000000000000001
11000000000000C000100000000010000000000000000000000000000000100000000000000000001000000000000000000000000000000000000000000000000000000000000001
111111111111111111111111111111111111111111111111111111111111111111111111111111111111111111111111111111111111111111111111111111111111111111111111