111111111111111111
110000000000000001
110100000000111111
1111000P00001E0001
110100000000111101
110000C00000000001
111111111111111111