111111111111111111
110000000000000001
110100000000111111
111P000000001E0001
110100000000111101
11000000000C000001
111111111111111111