11111
1PEC1
100N1
1PEC1
100N1
11111