11111
1PEC1
10001
100C1
10001
11111